#^####
# #  #
#     ##
# #    #
###E##
